00 00 00 00 00 00 00 00
00 00 00 00 00 00 00 00
00 00 00 00 00 00 00 00
00 00 00 00 00 00 00 00
00 00 00 00 00 00 00 00
00 00 00 00 00 00 00 00
00 00 00 00 00 00 00 00
00 00 00 00 00 00 00 00
00 00 00 00 00 00 00 00
00 00 00 00 00 00 00 00
00 00 00 00 00 00 00 00
00 00 00 00 00 00 00 00
00 00 00 00 00 00 00 00
00 00 00 00 00 00 00 00
00 00 00 00 00 00 00 00
00 00 00 00 00 00 00 00
00 00 00 00 00 00 00 00
00 00 00 00 00 00 00 00
d6 23 40 00 00 00 00 00
11 23 40 00 00 00 00 00
d1 22 40 00 00 00 00 00
48 00 00 00 00 00 00 00
61 24 40 00 00 00 00 00
6d 23 40 00 00 00 00 00
59 23 40 00 00 00 00 00
20 23 40 00 00 00 00 00
e7 22 40 00 00 00 00 00
33 21 40 00 00 00 00 00
35 37 38 38 65 39 65 37
00 00 00 00 00 00 00 00
00 00 00 00 00 00 00 00
00 00 00 00 00 00 00 00
90 00 00 00 f0 00 00 00
